NO ./north
SO ./south_texture.xpm
WE ./west_texture.xpm
EA ./east_texture.xpm

F 111,111,111
C 225,-0000,1



1111111111111111111111111
100000000011000000000000
1011000111000000000000111
100100000000000000000001111111111
111111111011000001110000000000001
100000000011000001110111111111111
1111011111111101110000010001
11110111111111011101010010001
1100000011001011100000010001
10000000000000001100000010001
10000000000000001101S10010001
110000011101010111110111100111
11110111 1110101 101111010001
11111111 1111111 111111111111
