NO ./north_texture.xpm
SO ./south_texture.xpm
WE ./west_texture.xpm
EA ./east_texture

F 255a,100,200
C 225,0,1



1111111111111111111111111
1000000000110000000000001
10110001110000000000001
100100000000000000000001
111111111011000001110000000000001
100000000011000001110111111111111
1111011111111101110000010001
11110111111111011101010010001
1100000011001011100000010001
1000000000000000110000001000
10000000000000001101010010001
11000001110101011111011110N0111
11110111 1110101 101111010001
11111111 1111111 111111111111
